lem_ipvdfc	pos_fgltnv	tok_biikzz
lem_aoybbb	pos_khtvam	tok_cducmt
lem_wuxglq	pos_unexmr	tok_xacoll
lem_nmkhds	pos_frlvcn	tok_kvaxes
ne	POS	ne
lem_rfhzeh	pos_qofbre	tok_hklguz
lem_efrbkp	pos_qxlgwb	tok_beyiag
lem_gyojwr	pos_gtorlq	tok_dgzbak
lem_bepbvs	pos_nccqcm	tok_zgepft
ne	POS	ne

lem_dyalzd	pos_xsyucj	tok_wejmok
lem_qyqlzf	pos_mzrtje	tok_ufuqyq
lem_hhkjzd	pos_oamphr	tok_idbxtk
lem_hkkzsv	pos_tnvnrr	tok_wqtgeo
ne	POS	ne
lem_sicmgq	pos_purbmq	tok_wconqz
lem_lurbuv	pos_tdfrxx	tok_imjaxp
lem_ysjwjf	pos_xwwpvr	tok_bdqtqo
lem_glklzz	pos_lczkne	tok_bmbema
ne	POS	ne

lem_naqcmi	pos_jotiwj	tok_lavuwh
lem_ysqsdc	pos_ghzdii	tok_dhwepm
lem_pwneik	pos_gokcrp	tok_fnmsxw
lem_dwqccu	pos_qusoqg	tok_fskrfn
ne	POS	ne
lem_hoorik	pos_vsbolk	tok_eyjffz
lem_rxkqpo	pos_lwdlcq	tok_cpxiqh
lem_drtqok	pos_vdylyg	tok_vfzxjv
lem_vjeipu	pos_qpzntn	tok_kmlbbi
ne	POS	ne

lem_tdjbqz	pos_yifoap	tok_gegibq
lem_kxubhr	pos_rrdzjv	tok_wotrwo
lem_yykklb	pos_opsgqj	tok_xzswki
lem_nmcuul	pos_jrtffg	tok_ltrxnt
ne	POS	ne
lem_ssiyaq	pos_cvvgqw	tok_mgtagh
lem_waojqf	pos_tzzmfx	tok_lcafcl
lem_ocfgyq	pos_bimkyf	tok_jxhysb
lem_ttklwb	pos_byxhuf	tok_ayjfgg
ne	POS	ne

lem_ruiazx	pos_bgotrr	tok_cjigko
lem_jrgtwa	pos_tlxitf	tok_urgkkq
lem_zvlygo	pos_iwrsdm	tok_ckobil
lem_kvceub	pos_gixqze	tok_miwavi
ne	POS	ne
lem_ullnhi	pos_qvskoi	tok_iaxglo
lem_ugsbww	pos_xwqzte	tok_ccoguu
lem_hfrqmg	pos_zlcnsi	tok_qkypqo
lem_gvrbtl	pos_ovscaw	tok_ohdgjg
ne	POS	ne

lem_kjgtse	pos_nhjpvq	tok_kpsfei
lem_etovsd	pos_stfgkq	tok_yhugdq
lem_poxktd	pos_xjjbny	tok_asttwm
lem_qyeiqp	pos_hwvbjw	tok_fhnnrv
ne	POS	ne
lem_hgcjya	pos_gpcxnu	tok_quadih
lem_ejqowq	pos_nppaeb	tok_nohdeh
lem_kpfqas	pos_ytjtzw	tok_jbcmiw
lem_zrxhft	pos_cwvxdg	tok_dqedkt
ne	POS	ne

lem_hkiyhg	pos_kkykoq	tok_pgezqe
lem_tsmvoc	pos_jnmuxp	tok_ghdyvo
lem_ggcgre	pos_ooalgw	tok_diukvi
lem_tilxew	pos_lwoajx	tok_qslfzs
ne	POS	ne
lem_smmpsi	pos_iohrlo	tok_wzfclg
lem_gafofr	pos_xjwwsf	tok_brkppk
lem_cdeake	pos_wvojbz	tok_zdycvu
lem_plrjpe	pos_gzmkkn	tok_gzszop
ne	POS	ne

lem_woatle	pos_tebjjx	tok_slnzmg
lem_nuhtvx	pos_kltwix	tok_xycqcc
lem_aflvsz	pos_seyskj	tok_furmjv
lem_kglmaw	pos_pncysu	tok_wxzfif
ne	POS	ne
lem_qttrim	pos_iinznc	tok_fgjeki
lem_fvzdoj	pos_yfpvtq	tok_jrfsgj
lem_nhrgym	pos_mvyxsy	tok_paxlea
lem_gqetmt	pos_ytyrzl	tok_hjhpsk
ne	POS	ne

lem_swhuxt	pos_snqsew	tok_mypgmp
lem_vdmwak	pos_rcqdix	tok_wxoswo
lem_dqffep	pos_hwbphw	tok_qmbqex
lem_wkaqjk	pos_hfjzsb	tok_xclxgl
ne	POS	ne
lem_jdbjcq	pos_tzgcjg	tok_ocijno
lem_papvpt	pos_rqrqtv	tok_iyoqwk
lem_jdwflx	pos_azubpw	tok_zbaxpb
lem_aitmsy	pos_jbamwz	tok_cayral
ne	POS	ne

lem_tifwqb	pos_okjegj	tok_nidhfy
lem_ujxtat	pos_eyislm	tok_uoebgk
lem_yhzqcf	pos_cwmuje	tok_xgfadn
lem_rlxkqz	pos_kmlkih	tok_mqguqo
ne	POS	ne
lem_bstoba	pos_bgqtcl	tok_nbhhht
lem_cadlfo	pos_impael	tok_abluyd
lem_cdundq	pos_bljhzs	tok_lcolzd
lem_arqalm	pos_kkkyyh	tok_pncllz
ne	POS	ne

lem_cwdwxh	pos_ovyybd	tok_nwnwvu
lem_qinieg	pos_pbksar	tok_zvelmc
lem_nazmtl	pos_qzutxa	tok_mexzmz
lem_lumxvs	pos_iqdrrc	tok_ahhoeg
ne	POS	ne
lem_ouinog	pos_krgktj	tok_gogthe
lem_aezgzw	pos_jaxjxd	tok_lqjtni
lem_xstklm	pos_aubucp	tok_nvcbtz
lem_xomgiw	pos_cmklak	tok_ajdvrz
ne	POS	ne

lem_uepblm	pos_gdpmxb	tok_pdtscd
lem_bslher	pos_fbcxqq	tok_jzjthb
lem_stofwe	pos_ahqpsg	tok_gunpfs
lem_ocwupk	pos_hdcvjw	tok_fsnpwy
ne	POS	ne
lem_ataqpm	pos_hwqqgx	tok_cebals
lem_svnbph	pos_urcfeu	tok_ruzqti
lem_imlchy	pos_rmuqhr	tok_ergijf
lem_wcqxij	pos_cvcage	tok_isnpid
ne	POS	ne

lem_fdztne	pos_cibqfd	tok_zmrxzl
lem_unybeo	pos_xfaayg	tok_epcarq
lem_zalfyh	pos_oskuiw	tok_rjfbbr
lem_krlkzu	pos_ufvmhy	tok_jskzdz
ne	POS	ne
lem_hzeloi	pos_itedaj	tok_uryoxe
lem_mkoxsv	pos_acbmpq	tok_wijzlw
lem_pfqrxm	pos_ksjquf	tok_pzmaco
lem_kuanxg	pos_twiubc	tok_iuchwm
ne	POS	ne

lem_tgyvyp	pos_cpcezd	tok_umxpgs
lem_oylgum	pos_amusaj	tok_shtrva
lem_ottrer	pos_xmergg	tok_nfzkrr
lem_tfpoxv	pos_jubcdl	tok_bbruqq
ne	POS	ne
lem_tcrtan	pos_iaayxt	tok_tgxpnd
lem_hbswcc	pos_pviitz	tok_bnaqpw
lem_gruvrp	pos_rgknnc	tok_gpaxwe
lem_dtmsfu	pos_kskved	tok_dhpzmy
ne	POS	ne

lem_oddcys	pos_bkhkpd	tok_xzdgxd
lem_xnrrnv	pos_yaheqi	tok_wpaqdg
lem_wqeffg	pos_cpceef	tok_atmejh
lem_qcnzqa	pos_egatxm	tok_ynazfz
ne	POS	ne
lem_fsjiqq	pos_yndddq	tok_bwqgoi
lem_iiobzu	pos_eyzmpn	tok_dsmswx
lem_mqpmgy	pos_jyoqiq	tok_liceiy
lem_wrlild	pos_qeyjig	tok_vllmqu
ne	POS	ne

lem_utcjqa	pos_omwifn	tok_peneof
lem_iivlzs	pos_dkyvjo	tok_ljpvlk
lem_rhawah	pos_rzfvsv	tok_voxfsv
lem_uizwcy	pos_aiouxv	tok_uuaqhb
ne	POS	ne
lem_bzeicx	pos_fottdo	tok_ctailg
lem_ioagiw	pos_njaqmp	tok_octtpm
lem_wkuvpb	pos_scpwvx	tok_qfoxey
lem_zcyave	pos_kmuqei	tok_udznpi
ne	POS	ne

lem_fvqzit	pos_mnvsfe	tok_eqdagn
lem_yuzwzo	pos_prvmzz	tok_ropren
lem_abakkl	pos_gjyrda	tok_upiqij
lem_rwotmr	pos_mcmpls	tok_mmfbtu
ne	POS	ne
lem_tjauvy	pos_kcfstt	tok_gqdwlw
lem_rfwyqy	pos_yfosnr	tok_cogbon
lem_hwcsez	pos_sreeyh	tok_tcpjtb
lem_kndmoi	pos_ubszec	tok_rlsfzk
ne	POS	ne

lem_yccsri	pos_eipykf	tok_xbgbav
lem_cpelsw	pos_ifkjrw	tok_ogaumj
lem_arxvyh	pos_rtcrqw	tok_hlhoxd
lem_ivehpy	pos_ganyjl	tok_moexil
ne	POS	ne
lem_syewqb	pos_dmwnns	tok_grobua
lem_lddvqi	pos_zzeudn	tok_amuldu
lem_ytvjub	pos_vlthpi	tok_nswpxt
lem_zkonok	pos_dwvzwk	tok_vlvdri
ne	POS	ne

lem_aazpvq	pos_uaypsu	tok_sywgcm
lem_gkoopv	pos_qgmfhe	tok_fjeknc
lem_vwypba	pos_aemtja	tok_bagbcl
lem_ghwhfa	pos_pagmst	tok_bslaaq
ne	POS	ne
lem_sveftx	pos_ewyior	tok_fvpdza
lem_cvmhwz	pos_vuekqa	tok_srnmkk
lem_tecbwa	pos_ewckhm	tok_ihiupw
lem_qfveis	pos_ksbstd	tok_dsjasa
ne	POS	ne

lem_gnqkph	pos_hfccxy	tok_geemes
lem_uslotz	pos_mvmifq	tok_nrlqqg
lem_ccroeo	pos_onnmfr	tok_cgfjjs
lem_mgkobb	pos_gnhirk	tok_ptwlxw
ne	POS	ne
lem_qnofkc	pos_hmgpqg	tok_kumear
lem_gkafyt	pos_ttdtes	tok_ixvlae
lem_ftcqcs	pos_dlxsls	tok_ojytrw
lem_lyyfnu	pos_xbmdea	tok_urmhjm
ne	POS	ne

lem_czttis	pos_dboltw	tok_akmjdy
lem_fywnnr	pos_juwexj	tok_chpdgh
lem_vtzqfz	pos_nlkktp	tok_mypern
lem_ryutvl	pos_wtiqrt	tok_ernkgo
ne	POS	ne
lem_czuukt	pos_ucnuvn	tok_jqodsr
lem_wzjixt	pos_nrsmrd	tok_acqfia
lem_frjcla	pos_pprnrs	tok_myvtmg
lem_wjlsjb	pos_chzdsl	tok_acpsqd
ne	POS	ne

lem_pchcxb	pos_ccvmhz	tok_wtarol
lem_xrebao	pos_ebefvx	tok_txawib
lem_tcymom	pos_xyzzbq	tok_echyxg
lem_ncsrwt	pos_dmrxfs	tok_quapuk
ne	POS	ne
lem_tjmuuc	pos_jngpml	tok_iedleh
lem_hrhnxk	pos_hjenlt	tok_yhwhtt
lem_sbwrzq	pos_sjtrcb	tok_gsmbmo
lem_epaddg	pos_vcsphm	tok_urqjmh
ne	POS	ne

lem_dzttzk	pos_nagfjs	tok_itvycm
lem_qlfxvh	pos_joafov	tok_qtwdzu
lem_kelqlb	pos_pdokvx	tok_muxgld
lem_uofalp	pos_bqzwas	tok_zcjcjf
ne	POS	ne
lem_bzrpxi	pos_gamxgi	tok_rzqvzw
lem_jgrxer	pos_ikszhf	tok_owynlf
lem_kmxtde	pos_qbhnos	tok_gvjlfz
lem_kcyexs	pos_dcqflp	tok_vocjcv
ne	POS	ne

lem_flbmun	pos_tvkran	tok_ojqjux
lem_rkxfvj	pos_vmegnn	tok_xwvuxi
lem_jcmhlh	pos_equmyy	tok_zccocs
lem_qyviwo	pos_pqombp	tok_patpgn
ne	POS	ne
lem_qtrmrg	pos_gtjsvo	tok_aelvqx
lem_knmaqu	pos_kpuyzj	tok_ddghlk
lem_gdlcsm	pos_cswcmx	tok_nfrfhz
lem_alwohf	pos_rctzvv	tok_eibblu
ne	POS	ne

lem_rvjbfm	pos_bhfsyd	tok_aunfkq
lem_cwcakk	pos_yzikra	tok_vprdym
lem_fyrrgh	pos_dfyqes	tok_tinimj
lem_hguwws	pos_uafrka	tok_iuvjxl
ne	POS	ne
lem_svuyyg	pos_amecpa	tok_tsypds
lem_pdjnir	pos_sdbmjw	tok_gtutub
lem_sealzr	pos_nwnfqg	tok_aitnlq
lem_tycknf	pos_dlsobv	tok_fytgnc
ne	POS	ne

lem_jefibl	pos_ouebye	tok_itxeaz
lem_karwrq	pos_hihaqw	tok_bifoxp
lem_epxxvw	pos_ggdqtk	tok_dfylxi
lem_bemuar	pos_gbzykl	tok_yidubj
ne	POS	ne
lem_cqvcuo	pos_yhekmi	tok_feelug
lem_ctebef	pos_kxgdiv	tok_mhuuhj
lem_fuszqi	pos_siatum	tok_xneueg
lem_vbmvkn	pos_twjlbu	tok_ckvqfp
ne	POS	ne

lem_regpxs	pos_etrgrg	tok_wixpjt
lem_wjgjak	pos_pdckae	tok_yuppio
lem_ynunfl	pos_hrpzod	tok_ibwysx
lem_cxwysb	pos_zrphxt	tok_urssbh
ne	POS	ne
lem_aptdxp	pos_ofvqqb	tok_nfaqno
lem_hiisuo	pos_nprbst	tok_opbxhl
lem_gmqrjv	pos_rypbak	tok_ljhpsu
lem_lcwjyx	pos_xfjnis	tok_tozamj
ne	POS	ne

lem_vpzmtz	pos_iuwkwv	tok_opqcqd
lem_fsuqgq	pos_accxsd	tok_rrrwdn
lem_nefpxs	pos_mgwzbf	tok_jkpvvm
lem_goniiz	pos_gxdsio	tok_prprlw
ne	POS	ne
lem_vcvtta	pos_cbicik	tok_qsljao
lem_nyybjt	pos_mtbkzd	tok_gnlxkd
lem_nhrrmb	pos_kpndwg	tok_nvcuuf
lem_yqzwbb	pos_tnutko	tok_xuogwe
ne	POS	ne

lem_slypzt	pos_ocyaao	tok_qopdgy
lem_mwxper	pos_pirfdp	tok_ozgcid
lem_qfjscl	pos_lazvsh	tok_qednmo
lem_ghirgk	pos_qjmtwc	tok_pbzumc
ne	POS	ne
lem_wslmlu	pos_jlgbrb	tok_arkacc
lem_whvfwo	pos_ftjpow	tok_anxglu
lem_cvbkuq	pos_czaspd	tok_lmqjlq
lem_rjosmg	pos_znhurw	tok_ivgjha
ne	POS	ne

lem_zmibnj	pos_vcxook	tok_qdvoev
lem_upoyou	pos_xubvfz	tok_urkcxw
lem_cbbrjo	pos_gdksbt	tok_nwxeuy
lem_qpylcd	pos_ghsufg	tok_fskbyi
ne	POS	ne
lem_yqhixo	pos_ygqvyi	tok_shjehr
lem_glzyhe	pos_npcqoe	tok_iiuhcg
lem_vmtyjg	pos_utyeyf	tok_twyiql
lem_kjdfth	pos_vepdsz	tok_amzsqv
ne	POS	ne

