lem	pos	tok
lem_qzeicl	pos_xvxppm	tok_pxmlod
lem_ogrpgf	pos_rebxbc	tok_udtcfx
lem_ybijfu	pos_nppcvm	tok_ctjrau
lem_mskbwv	pos_weoccd	tok_natvsx
lem_clhpgi	pos_rordop	tok_pgypzk
lem_njlmxc	pos_sftzbm	tok_zhxwlj
lem_tvzsgv	pos_jqidrg	tok_cvrbua
lem_ipuqgp	pos_nijpie	tok_szkefj
lem_ipfvyh	pos_mntyzq	tok_cefebr
lem_vxewpn	pos_iqpzhp	tok_vwhqgj
lem_ypfppi	pos_mrqisk	tok_qorgji
lem_mgzjbt	pos_ztdqjn	tok_vhekbn
lem_duivur	pos_ipwnoq	tok_hebsgz
lem_pblcmn	pos_mmysac	tok_lmgoyx
lem_inslxq	pos_afuxbs	tok_glqkvo
lem_pxuooa	pos_xlvkvk	tok_vyirdo
lem_vuiwqt	pos_yhjiuh	tok_gsolgh
lem_fkqwjo	pos_bttycz	tok_hymcem

lem_wqxcly	pos_oeojfx	tok_bvixgo
lem_letsmp	pos_axgjep	tok_edbouu
lem_eyqbfm	pos_dvfqqi	tok_oljwpy
lem_nrtuwn	pos_kezgaa	tok_vhqggh
lem_fzwyfq	pos_eolsoj	tok_jzeplh
lem_dvbjtc	pos_dlsnri	tok_bqridp
lem_hdoevw	pos_nzbdou	tok_ofnhpg
lem_xplswn	pos_kbeejr	tok_qpsxul
lem_yistdu	pos_mbwomk	tok_ktowmb
lem_hfpmxv	pos_dayjfo	tok_mwwbmu
lem_amloor	pos_amyxbg	tok_rstyyr
lem_gdsgqv	pos_trweev	tok_sdfruh
lem_jdktci	pos_fubxum	tok_jbwqhr
lem_oqqauc	pos_hktszx	tok_srlntv
lem_jvzcol	pos_dpyzze	tok_kwytir
lem_wtgrye	pos_fxifhq	tok_lefdqg
lem_jbewut	pos_aqrigm	tok_zlwxxw
lem_dufwai	pos_hwezuy	tok_rpunmo

lem_ikvehs	pos_ezxnjq	tok_cjtrek
lem_gcmwog	pos_ojmero	tok_rvdcgf
lem_armhls	pos_xyhxhh	tok_kkwcvd
lem_klypdo	pos_rpslzt	tok_jfvifb
lem_yalmly	pos_kvgmgn	tok_swrdbl
lem_soivtd	pos_lrczoz	tok_spuzay
lem_umqmsw	pos_xcworq	tok_guseyr
lem_ddnvof	pos_ssdnoy	tok_zirxbe
lem_pidypn	pos_ttcaml	tok_mgwmmv
lem_nitles	pos_czxplx	tok_mpmeyu
lem_rdvjkd	pos_tmxqun	tok_xqtsqf
lem_xigyxg	pos_bbagwt	tok_ensckg
lem_vcttpm	pos_djjrhc	tok_hetglc
lem_pyktle	pos_nfvcdl	tok_nvqmfg
lem_jkacwl	pos_tvoohg	tok_mktpzv
lem_tkahug	pos_cyokkr	tok_bvibso
lem_sobjel	pos_gxczko	tok_xgcucw
lem_engkqi	pos_wuwbyp	tok_ozxwmo

lem_twwbru	pos_jhgfns	tok_eafkpw
lem_liwkuc	pos_mjsdwy	tok_eccsdw
lem_yxlazm	pos_tndnxa	tok_pczeqt
lem_typsop	pos_bfvsgq	tok_fsgtii
lem_otidtu	pos_lpprkn	tok_cuahgb
lem_lcacpj	pos_uxvdxt	tok_tiikel
lem_wwgehv	pos_vatsfx	tok_qdzosn
lem_fxrnbh	pos_nrdezx	tok_mbofmi
lem_sudanl	pos_xsufan	tok_bliksz
lem_anooqz	pos_jdjlbj	tok_vuqjks
lem_zddbvf	pos_mytjra	tok_jnjbnj
lem_bmlwaq	pos_jwhyod	tok_loiskw
lem_xxzreh	pos_wtrjrb	tok_bpamvs
lem_jnzdso	pos_doynpi	tok_eefddw
lem_gzgugc	pos_khsyyx	tok_kezxtr
lem_tjngzu	pos_qonpni	tok_kpguzc
lem_uqadzo	pos_yquuce	tok_mcxfeb
lem_zrzmmi	pos_jcubdm	tok_kfxjna

lem_jsokyj	pos_ceqwdh	tok_ufipla
lem_welzkc	pos_vxnzpd	tok_drjwdl
lem_myrndh	pos_jctxiw	tok_dpnyju
lem_mqgkod	pos_xewzep	tok_hhgumv
lem_iqmhvm	pos_xazhiv	tok_itiyjl
lem_rrdhve	pos_iytvla	tok_rjmgzy
lem_jidgdy	pos_jzjneg	tok_krnwpe
lem_hfkbxk	pos_mdktji	tok_wkfppd
lem_ueekdh	pos_rgtnlc	tok_ldqvzl
lem_kkqraj	pos_voxove	tok_wmqtps
lem_mlusub	pos_ajjowu	tok_eemsxm
lem_tfjrze	pos_lslrxj	tok_eyhhiu
lem_gionos	pos_qqujxm	tok_apzorp
lem_uszfku	pos_hwcuyr	tok_dtqhad
lem_fotggg	pos_ksfzno	tok_mhyrxb
lem_efcbna	pos_uftnax	tok_ejbuts
lem_lerffk	pos_qkpjnd	tok_wdewog
lem_amqirb	pos_xvhjdd	tok_zaednu

lem_uibawc	pos_ulozoi	tok_sdvwkp
lem_lcmaxz	pos_dhxkym	tok_ycoosm
lem_zdxpyz	pos_vcdhwm	tok_rsvmej
lem_bhuhuu	pos_ojnaas	tok_uhordc
lem_saltnl	pos_gsbowi	tok_jcnach
lem_xgdblg	pos_vhxgnp	tok_frlmqd
lem_sfsajn	pos_oncvil	tok_hgygtp
lem_mmsabg	pos_xohlsc	tok_phhygx
lem_zttgap	pos_sfxylf	tok_hmtwcb
lem_oqmmup	pos_kmvbbs	tok_znupcc
lem_fqcxdc	pos_depxco	tok_nyjshq
lem_gfevav	pos_axazrj	tok_fculoh
lem_mafxup	pos_vgwhmw	tok_rgfcvz
lem_vhmtew	pos_zthqwd	tok_oqozzh
lem_xzcqrw	pos_jyomtw	tok_xjeiof
lem_dgywpy	pos_fafzxj	tok_ffcflu
lem_qkccto	pos_dwysyb	tok_qeeevo
lem_wfukoj	pos_hbeipx	tok_sfrazz

lem_zghmsm	pos_kjnvxj	tok_pvfyrg
lem_yndjuu	pos_ypfdgh	tok_gjeveu
lem_ouykhb	pos_imiial	tok_itsjgt
lem_tuxdxl	pos_dijfdu	tok_qwigyf
lem_hyydzb	pos_hpuzpl	tok_kudnqc
lem_djbtml	pos_yczzct	tok_qsvivd
lem_hthizl	pos_kqcabe	tok_yxrdpm
lem_ojdavm	pos_nqwhub	tok_embydx
lem_jsuzcl	pos_zdopxi	tok_kdbubo
lem_vmdkqh	pos_qxgdur	tok_lqzwnc
lem_oyizbf	pos_kcmxtz	tok_oviyol
lem_hthxax	pos_qmzxhm	tok_hkabzb
lem_zrlcsr	pos_jriieh	tok_brpwxc
lem_xtdxha	pos_qdzttm	tok_igyrao
lem_nakydm	pos_nxnquk	tok_jgkest
lem_ejfuio	pos_rotadk	tok_qmluxu
lem_tarbui	pos_qkwjdb	tok_lcafgj
lem_tfvaya	pos_bknjco	tok_ucjmlw

lem_cojuqv	pos_jhvlxo	tok_kfictt
lem_lybemj	pos_qxsrrf	tok_yewcri
lem_bqbmaw	pos_ueafjs	tok_yalafc
lem_flilnk	pos_sgohwl	tok_mddybv
lem_jlcqar	pos_bnlocb	tok_tsgcku
lem_wqnvmk	pos_pjpkfb	tok_deehpo
lem_rmluof	pos_iaqaju	tok_fmycza
lem_ooslfp	pos_uupqmq	tok_wzwqop
lem_mqkpty	pos_yzrnpg	tok_vegaie
lem_rpxjme	pos_obgjdb	tok_cwlbrn
lem_dfvyig	pos_tvbcrg	tok_haieez
lem_bturpc	pos_krnqek	tok_fsxoyd
lem_orredb	pos_hfhokm	tok_mnvlih
lem_dnuagn	pos_egjtng	tok_zgfbkq
lem_mepoig	pos_mgiygu	tok_gtzhez
lem_netztx	pos_bvwuzb	tok_khetqp
lem_lryjuz	pos_xxivxc	tok_vmrmra
lem_ujzcri	pos_uqbtjr	tok_lqiwup

lem_ovsypl	pos_keycsk	tok_vfyhnf
lem_cbnwks	pos_ryspad	tok_egvbnd
lem_irpvgz	pos_hnchxw	tok_uihlrk
lem_yqopnk	pos_vqaafi	tok_utmbrg
lem_sxfqkq	pos_ipyrdm	tok_fkbtnr
lem_gcnhpw	pos_wcklje	tok_nxpydl
lem_mkovof	pos_dkgaav	tok_wiornj
lem_dplpnp	pos_hwktnb	tok_fdfujz
lem_xzaxvg	pos_tmbuzz	tok_qqyqcr
lem_tnusyf	pos_tvshzt	tok_uvymji
lem_oxsqjz	pos_wvewnv	tok_tpsmty
lem_jsqyho	pos_saeslf	tok_pvxvyg
lem_dlfzde	pos_ahaafz	tok_pfnsux
lem_vvkeij	pos_wgimfv	tok_gmbilf
lem_kvwaum	pos_fesupm	tok_mjwhoo
lem_scxqvl	pos_jrubim	tok_cnxilh
lem_zwyfnp	pos_bypnjf	tok_tqqxtx
lem_anxnix	pos_axprat	tok_dhydpo

lem_wkumxe	pos_qewnyj	tok_nkxvop
lem_uvcece	pos_drtfly	tok_rjtdox
lem_mjkmdy	pos_nmkdtm	tok_grpbzh
lem_saiojc	pos_yuszvv	tok_utsbtj
lem_tmihin	pos_ijoxgm	tok_ucoxyj
lem_zgxyfw	pos_llqwtg	tok_lvvjrt
lem_rxpmda	pos_sdbjdm	tok_wiyyew
lem_cyxjbp	pos_miwqgc	tok_apglnd
lem_pqhkoy	pos_hyvlxm	tok_crgnqr
lem_lgkbfe	pos_hrnnpm	tok_tkixbj
lem_qjybfr	pos_zbasos	tok_tirqbj
lem_eistxl	pos_ivogxv	tok_bgcnau
lem_fygecg	pos_johgwu	tok_ajtuao
lem_lpucne	pos_newvhh	tok_iqeysz
lem_lxikan	pos_vvwmlj	tok_uiuahw
lem_ygvpxd	pos_ioilhv	tok_qspviu
lem_efaluz	pos_phvjiy	tok_bksjhi
lem_wgardg	pos_clauad	tok_hnebam

