lem	pos	tok
lem_pbcpjx	pos_kqhpdl	tok_oqwkjm
lem_apfsep	pos_btcllj	tok_xhrppr
lem_iweqqw	pos_szespz	tok_eborof
lem_sgaoaa	pos_bknmnr	tok_xxoyyo
lem_suzeyp	pos_nxvjax	tok_pvbqxo
lem_ckthpo	pos_scscgt	tok_sifsbr
lem_behnhm	pos_vkytnb	tok_lmgddw
lem_oazfcf	pos_ytqpqn	tok_wvireb
lem_upcnrw	pos_deafoy	tok_etkyqe
lem_utvmqa	pos_gpkzgc	tok_tfaodr
lem_ngzzqg	pos_wrnqsf	tok_ymrswl
lem_fekkcf	pos_rtqxhc	tok_wgafto
lem_yivvxf	pos_twzmjc	tok_frppta
lem_doidoa	pos_vtrdwy	tok_uiryzq
lem_fluwff	pos_yjwbgv	tok_yvriwo
lem_myctxr	pos_wfovtw	tok_aijzgo
lem_qtobzk	pos_xcygex	tok_rawbjw
lem_emwwlj	pos_ztoowx	tok_kkjaeh
lem_tnnqxx	pos_ooroqw	tok_cldrrw
lem_kiojxu	pos_vctlyt	tok_mewsmm
lem_mggemh	pos_lqtxbz	tok_zrdktv
lem_cokzqw	pos_kdmeeq	tok_yyoqfa
lem_zguyqg	pos_rafksb	tok_vtsvno
lem_ymoypf	pos_iinedc	tok_nosnkg
lem_byektx	pos_usrcvv	tok_smhcgz
lem_uwtzlu	pos_sdckzd	tok_zaocqv
lem_ktoqaq	pos_ggnpze	tok_erhfdy
lem_aifdwd	pos_tnflrq	tok_rpemcv
lem_dezjtt	pos_xpsecc	tok_xfsgdl
lem_jkeytg	pos_pocrde	tok_wovizx
lem_bhghtj	pos_dhxgln	tok_ivmcsk
lem_mlcjvm	pos_yqnycn	tok_mrvzev
lem_vfagyk	pos_tzelwn	tok_lhsyti
lem_poskct	pos_wycwfv	tok_hfmuev
lem_nhrcjc	pos_hfjqed	tok_ardzew
lem_fhrary	pos_bszyxn	tok_ixcqoj
lem_zlfufb	pos_mpmgqi	tok_kwgeam
lem_chboar	pos_gynilb	tok_vlioon
lem_xmntfg	pos_oenqiv	tok_sjrjkg
lem_ewefzx	pos_awspjj	tok_aaeglw
lem_xvlftd	pos_pcuveu	tok_pcaqdn
lem_pwxcxa	pos_fzrkng	tok_ordbtn
lem_ooafpw	pos_hnqpqq	tok_qwqodf
lem_cnqphu	pos_pfmbqo	tok_qbdupm
lem_amkacn	pos_qttmtb	tok_yucoae
lem_enquzc	pos_ioarwr	tok_nkvnne
lem_scrvjf	pos_nbdynr	tok_waeabr
lem_tuigii	pos_ndutwt	tok_mugbmn
lem_jzlber	pos_zwekaf	tok_xzenla
lem_tcoijo	pos_ulrukd	tok_hnnfls
lem_tfdkej	pos_ktuypa	tok_cfgtcn
lem_twefgb	pos_zuxmgi	tok_caspme
lem_ahbxdo	pos_mqyepb	tok_tjedvc
lem_pyzdyy	pos_bypylz	tok_rlshhw
lem_jqzjzf	pos_owaxfi	tok_ggmzhw
lem_auwkio	pos_ligyrj	tok_jjleun
lem_yuxmui	pos_etiebd	tok_ikoaln
lem_ocygdi	pos_kzplld	tok_uoymqb
lem_wdtzdd	pos_ihtmwt	tok_rdeses
lem_uktfgh	pos_hpboga	tok_alfxzq
lem_hdsipq	pos_pzcrdh	tok_tmlklr
lem_zlbwsk	pos_jydwwu	tok_sfcgcm
lem_yvnyak	pos_hanjhh	tok_rauuwy
lem_wjtlbp	pos_wmowhg	tok_ydrojg
lem_zdrerb	pos_ofyfnh	tok_tcpdgw
lem_wijtha	pos_pzhpon	tok_gdmijq
lem_mnvxwf	pos_vnonru	tok_zkvcsa
lem_uxnesy	pos_qnxbuy	tok_jeanve
lem_kawghh	pos_hweyft	tok_qqrhuy
lem_tmincx	pos_fexodi	tok_yqhaak
lem_hhromy	pos_wpdvnv	tok_whzuha
lem_jnmboj	pos_iouboh	tok_cfwteg
lem_bxxtkv	pos_tvuvxb	tok_sbfgyk
lem_tofsgp	pos_ymsoae	tok_bpukwv
lem_aikjab	pos_hukvzt	tok_lbxbku
lem_tinjsu	pos_zzxlvi	tok_gjkrbn
lem_moqncb	pos_toempg	tok_vsrcfu
lem_rjvpoe	pos_lcnhpm	tok_yneeyg
lem_tkktin	pos_zwggew	tok_abkrsf
lem_uklmiy	pos_adbuky	tok_vbafru
lem_czswke	pos_aliure	tok_ilwbhc
lem_pewepb	pos_fktora	tok_tnsgrs
lem_dzucmu	pos_yctcef	tok_iibxsx
lem_bqfedm	pos_wyobjc	tok_tindsn
lem_qqxmsr	pos_zeccxs	tok_ampztl
lem_hptqzo	pos_cvfypf	tok_untwhw
lem_pzceru	pos_xhdvmb	tok_jakhqk
lem_ewgwyb	pos_iyscog	tok_gdlvra
lem_faublo	pos_wobxxz	tok_xpnavc
lem_lpornk	pos_xoprlv	tok_mlwakd
lem_txzphq	pos_poxatg	tok_qjuhmi
lem_ytdrsn	pos_hpkxrc	tok_additf
lem_inpwsr	pos_ydaorb	tok_zumbiz
lem_hpdxsg	pos_vaxnzv	tok_nrgqbf
lem_jufggb	pos_gihusp	tok_xdeqce
lem_bczmvr	pos_gkxxfj	tok_odijtt
lem_mlmoiw	pos_xcpwrd	tok_qqgsjd
lem_byilfy	pos_yvbvpy	tok_cytdvu
lem_ojbsfz	pos_vsoisu	tok_kwbyqu
lem_grytyl	pos_srhpro	tok_lpiubo
lem_fxtvme	pos_kqbgtr	tok_txcyxe
lem_vzobrk	pos_rddxfm	tok_qplura
lem_qhhhbo	pos_dajltl	tok_vrhkca
lem_rqlypt	pos_lhlnzs	tok_zenqfl
lem_hbhvsn	pos_cwdzre	tok_waxpsx
lem_fzwksa	pos_egmdxr	tok_lsbzev
lem_nvcfuj	pos_bzwfby	tok_ueyuyo
lem_fdznjj	pos_ivwmrk	tok_amvynx
lem_snjniy	pos_wfkets	tok_dctgjl
lem_ifvmib	pos_xbopvk	tok_jsandg
lem_xschoc	pos_shhrco	tok_vvmaem
lem_puwjij	pos_omozrt	tok_ckrucf
lem_qwywln	pos_pyoqku	tok_igiqdq
lem_nevfbp	pos_btlwsg	tok_mrdyqv
lem_zpuxip	pos_wmoqks	tok_etvibx
lem_hzfvfz	pos_etrkcw	tok_istzvw
lem_scgcyg	pos_lpgtlk	tok_qitenp
lem_blltfj	pos_waonmf	tok_xpngfq
lem_furguq	pos_hytwwl	tok_cuajyk
lem_osvzgr	pos_awrpbi	tok_nmbvvc
lem_aqsscu	pos_wmxljr	tok_jsicki
lem_xvimuy	pos_ucfqdm	tok_xbluhf
lem_pjyjdz	pos_iwvmoe	tok_yroawj
lem_lznxlu	pos_otuomc	tok_jzevvn
lem_aeatqw	pos_oejlas	tok_orockg
lem_skwcai	pos_wcvvxz	tok_tajmso
lem_rjtwip	pos_dosmyr	tok_kgrumy
lem_mpilnc	pos_nmjkae	tok_fgqsfu
lem_fjohlq	pos_kmqszt	tok_kuprwb
lem_rwfiuo	pos_juapsp	tok_qhagft
lem_dsjvlf	pos_cfgfku	tok_olypqh
lem_cfhagl	pos_szqwot	tok_bujzav
lem_ltrhlr	pos_ubvqal	tok_jfglkh
lem_vgstin	pos_jejljd	tok_rnopno
lem_egokfb	pos_qdqpon	tok_dpetow
lem_rprcep	pos_wkrtkm	tok_oxwbtl
lem_ozgojj	pos_krwjlh	tok_yymeqg
lem_mmfwfe	pos_udwtku	tok_iaorqw
lem_jdyjpo	pos_kjvgkb	tok_rkpbok
lem_aivjce	pos_uxmhgq	tok_xqfjne
lem_yswkwz	pos_qhbngj	tok_goxqwv
lem_pyxnav	pos_zknopy	tok_dgyilg
lem_myywqn	pos_bvyzvn	tok_bwmvxd
lem_nhpfsc	pos_bujsjs	tok_nhugkk
lem_ocyeoq	pos_tkmgkf	tok_dwxzhq
lem_aqumbp	pos_ucwlbg	tok_fdvtvi
lem_sumuid	pos_xxbfex	tok_uuenos
lem_tmssok	pos_ramgjt	tok_mawgan
lem_qyerye	pos_ovtabk	tok_trpxrk
lem_hbokzx	pos_zfjbgk	tok_wxpzyq
lem_cwulqh	pos_wmjlyj	tok_hhcfaw
lem_ldcubz	pos_qompew	tok_jwbeqy
lem_hrdevv	pos_ppoyda	tok_ugwoqt
lem_yijchq	pos_rwzryo	tok_pxxfip
lem_gfrkru	pos_uhkpra	tok_ricpoo
lem_evzqov	pos_likcbg	tok_hkqzqn
lem_drjuyh	pos_ylebqg	tok_pxutnq
lem_diotid	pos_akpmim	tok_ddtvzs
lem_xdspui	pos_vpaeuq	tok_shmvfe
lem_djytkz	pos_ybtnjo	tok_xtefox
lem_rnxdrw	pos_mqmwyc	tok_avqwca
lem_fpyyhi	pos_rtajyx	tok_otmwix
lem_solhtg	pos_bifyyc	tok_fvmvhn
lem_urcdpy	pos_vskoqk	tok_sarqhx
lem_wsmdqq	pos_dndola	tok_gxsiyu
lem_wuyymd	pos_mfmbmt	tok_nnnyqi
lem_txmhsk	pos_vmkfzw	tok_odjyku
lem_qknmil	pos_hjeiec	tok_uoazry
lem_azfckp	pos_vpreve	tok_fayuug
lem_uxqhox	pos_enfmxk	tok_gzqzfb
