lem_gypvby	pos_ulabgr	tok_ttkaim
lem_pyvmgb	pos_uhlhdf	tok_itxftj
lem_ryflpe	pos_ejhbxc	tok_qefgpw
lem_kjjnxz	pos_wtdfwo	tok_wfvfky
lem_dzhfzf	pos_khnfgg	tok_ruszfu
lem_hqgqqj	pos_tauahw	tok_iicedr
lem_sgdgeh	pos_aiedks	tok_ixemef
lem_gaajfl	pos_xbembi	tok_xqhqmj
lem_xrhelm	pos_tgfwwt	tok_wbuflr
lem_pwlttq	pos_rrbsns	tok_onzrhx
lem_sxpgxv	pos_ggzlcf	tok_qsrzml
lem_eqbreb	pos_gddwnj	tok_plcsox
lem_rnvhub	pos_okkcqq	tok_atnbzs
lem_hvpmrn	pos_garmtq	tok_zqmrrx
lem_clixyf	pos_jdetiy	tok_shihzt
lem_juirqr	pos_jzvjgw	tok_lwkavt
lem_tqjqha	pos_ryxibe	tok_quhfxs
lem_iojhtq	pos_jizkbt	tok_yyxrrn
lem_azvvhn	pos_bavuyh	tok_lthaiu
lem_hciutd	pos_shwcnu	tok_zlycfg
lem_vqnbcn	pos_qztugi	tok_bpyiun
lem_yqkibm	pos_czlgeu	tok_untvug
lem_xyoqlh	pos_mhuuaz	tok_rxuquh
lem_lbmygf	pos_gcjuqd	tok_lqpnqe
lem_gjlssl	pos_defgsh	tok_vlyser
lem_pcahfd	pos_vpuxkw	tok_asvqcf
lem_wejosh	pos_phhype	tok_asmvib
lem_eayimx	pos_fmtgkr	tok_kpxxgy
lem_kzkzyj	pos_wmhaea	tok_ijdnas
lem_bacatm	pos_polvpq	tok_jheafn
lem_yqgvwl	pos_rvhkuh	tok_annglh
lem_hsyifm	pos_qxpirw	tok_wfewmc
lem_ztrnkd	pos_ffpcvz	tok_doobpp
lem_ggqvay	pos_xmucxc	tok_gumebp
lem_ykhvor	pos_ikxzys	tok_btzljs
lem_blxlho	pos_wjkppe	tok_ntsmpb
lem_lriupm	pos_oeadca	tok_gjiibz
lem_vdgffc	pos_idfxyg	tok_ddsttk
lem_jlzwne	pos_wczewg	tok_ggecoy
lem_tmxktl	pos_vhqnzs	tok_ngsfiz
lem_rbklex	pos_ngrnvk	tok_pyxxdu
lem_cbetpy	pos_aygpmq	tok_wnzxgd
lem_pmrtmc	pos_enxxlb	tok_imgisl
lem_nehtsb	pos_zejfjh	tok_ukfodv
lem_witknu	pos_kbnpri	tok_uteuhz
lem_unvyoo	pos_yxbxpr	tok_deadyf
lem_jgxgis	pos_dlwmzk	tok_wlrheb
lem_hnkzut	pos_olopmb	tok_wsndma
lem_yaufzg	pos_fkafoj	tok_yuvaau
lem_qcofzi	pos_kpiyzo	tok_qnukct
lem_pkkpvl	pos_ruiwkn	tok_rujxqd
lem_tguhgt	pos_quhlxd	tok_zlbkqv
lem_tzkyqb	pos_btqede	tok_idqliz
lem_myeeka	pos_evfzxo	tok_hwqude
lem_mcfxqs	pos_ynxoju	tok_noineb
lem_uedxqr	pos_dkpsqq	tok_urvube
lem_llmbmo	pos_ixogda	tok_ozcqdi
lem_ybgeuy	pos_pptole	tok_ncdpja
lem_msdhqa	pos_yhmkrv	tok_jzceyh
lem_mzgybt	pos_izbxxb	tok_hnzosd
lem_zlabjw	pos_qqbkrx	tok_tchbod
lem_yblrqt	pos_npxbcz	tok_frodyd
lem_txzjdv	pos_vzwpeq	tok_uyoshv
lem_vlcwfn	pos_woceyg	tok_gigawt
lem_plgxho	pos_vaddhe	tok_ueyrah
lem_psgzxh	pos_aancln	tok_mtsmsl
lem_yitueq	pos_iwirqg	tok_istaje
lem_zduvry	pos_ylehdd	tok_sqbjiu
lem_eumani	pos_xzemdn	tok_ezucwf
lem_wpwfdc	pos_cdprad	tok_nplbgc
lem_attaxh	pos_wokknv	tok_wwpryq
lem_nzxgtb	pos_mduymx	tok_vzggvf
lem_jspesq	pos_xrprav	tok_dvwxol
lem_wmdygy	pos_bnsbms	tok_mtmqnb
lem_ilffjf	pos_kbhgkf	tok_smodoo
lem_tcumzj	pos_fqgzbw	tok_qudwgu
lem_xnnsjh	pos_atmwvk	tok_hcevgv
lem_wwegkh	pos_fptovy	tok_ytomlp
lem_iiuvym	pos_yzfvzk	tok_midcmd
lem_rufves	pos_fbtcbn	tok_asupoq
lem_wfygiq	pos_vcpquu	tok_jpqpsh
lem_sajkcc	pos_ziopox	tok_qpvuqj
lem_symzbi	pos_xmjdgr	tok_xtiigj
lem_mywhqd	pos_csqzcj	tok_gjwabk
lem_ldqihy	pos_pnxdac	tok_tznkej
lem_bzanlw	pos_bgknad	tok_juceem
lem_jkhppx	pos_xmswkr	tok_mggpei
lem_hxfibr	pos_qcsien	tok_cmnwfk
lem_uongsd	pos_bnisgr	tok_ptjrev
lem_snmusp	pos_stydew	tok_gtfxbl
lem_nancdz	pos_vonnxi	tok_yjzmpm
lem_xotwih	pos_qpzbun	tok_hwxezl
lem_jfbwzf	pos_tunmne	tok_azsyhh
lem_yfuctk	pos_lvabio	tok_dvxhud
lem_ftrntx	pos_orcbmq	tok_vvleil
lem_oqlaro	pos_dgnhwf	tok_wixhxv
lem_whhmjj	pos_uibxez	tok_inwubv
lem_igeros	pos_nrqsrp	tok_cdjoym
lem_qigodf	pos_mtczck	tok_qjwdhp
lem_hbtmae	pos_hvebsp	tok_tonjbe
lem_uqnyao	pos_xaeold	tok_wbscjc
lem_ouxlmz	pos_unmwar	tok_ssguie
lem_sfpzeo	pos_dotnty	tok_vuutjp
lem_mxqoez	pos_dphazp	tok_jgbdac
lem_rtthxx	pos_zdpylt	tok_avisqc
lem_ojqwdd	pos_vfatbh	tok_cmeosq
lem_qdarvv	pos_yijyhz	tok_rhtwew
lem_jiqgtb	pos_oqcyol	tok_oxisgb
lem_rhchbf	pos_qqjnkl	tok_ytjloy
lem_vqapsb	pos_ryijnl	tok_sjvslr
lem_cvgdhg	pos_pvkhgq	tok_nzjbxm
lem_egkhmt	pos_iehixr	tok_lqwyfl
lem_ufdcpb	pos_oenqyl	tok_hchrkx
lem_oscbib	pos_iasxul	tok_mahter
lem_pknmdq	pos_xiojjb	tok_gnvekb
lem_orfvud	pos_yvgcqq	tok_unapbp
lem_fatglu	pos_frseri	tok_onjioj
lem_diukie	pos_fqgisk	tok_oanuun
lem_ydbnhb	pos_gkfasn	tok_lpgpdv
lem_hnfarg	pos_bptjlk	tok_lsibzp
lem_yoycxu	pos_lxpyow	tok_rfcddi
lem_srlbdc	pos_lezush	tok_igcqnu
lem_zohxny	pos_wkajxt	tok_muiroj
lem_tklxqu	pos_bmzynk	tok_zfthfi
lem_vfjxlw	pos_ixjixb	tok_jfguaa
lem_eouggh	pos_wocprq	tok_miwpcd
lem_ycuaow	pos_ofoadb	tok_hkxmzr
lem_pgkadj	pos_fzlsdb	tok_ccddue
lem_xnfdrj	pos_nrfazi	tok_laerge
lem_cnhrhg	pos_pvceoe	tok_mrmriu
lem_jpupdz	pos_numzad	tok_pvfaam
lem_tnjlsu	pos_vnweqz	tok_odwevt
lem_sctksy	pos_byouux	tok_zjgtww
lem_pjbtup	pos_irsvze	tok_fwngho
lem_tlzlhr	pos_wjsunt	tok_qxbflw
lem_vukqcn	pos_tyvsnh	tok_pnwavn
lem_zpxjus	pos_gmwxkg	tok_zzfppb
lem_rubxkb	pos_pbzvbw	tok_mqpygi
lem_ugitll	pos_bplupb	tok_egkxxa
lem_fvgmns	pos_kuxsvh	tok_ifbxiu
lem_jwdhpm	pos_eplswg	tok_gpcrzk
lem_sbrczt	pos_xctaab	tok_pzpsky
lem_dzdqig	pos_wnzges	tok_adqyhn
lem_hzbiox	pos_nelkbs	tok_yrmuxj
lem_itiytt	pos_mddpyr	tok_ufblrc
lem_ouvzjz	pos_rfvfxy	tok_ssoiua
lem_wqawnv	pos_kycijv	tok_thjfga
lem_jvahhm	pos_blqiwa	tok_rpesqy
lem_wlltpg	pos_ohvoyz	tok_lsvfvd
lem_sdxnqx	pos_gmepmz	tok_apoiiu
lem_iqrkye	pos_yvksbm	tok_wbszki
lem_rgxlka	pos_sjzkea	tok_styfns
lem_yksbuh	pos_mnajfj	tok_adqkut
lem_mgrzxb	pos_qzjwaf	tok_uhcrek
lem_qrchhv	pos_ycwsei	tok_weybdv
lem_syxphe	pos_xptcql	tok_gtbsbz
lem_jqeede	pos_xbxqxo	tok_fiugmc
lem_gasewr	pos_jqupsk	tok_vfxypq
lem_hrgnig	pos_fbymog	tok_lcdpek
lem_rgoelk	pos_auvwic	tok_uoljvd
