lem	pos	tok
lem_iwhgju	pos_mvosgv	tok_nzhamv
lem_crzgoc	pos_rdcjhd	tok_glkhfx
lem_hskvai	pos_vsxoop	tok_pngmme
lem_fxexhc	pos_ghvzxn	tok_buwdow
lem_stcixd	pos_rbtdst	tok_rswvsd
lem_qgbyxe	pos_hpggfe	tok_lwsrcg
lem_gzhfyi	pos_mggsch	tok_hmevll
lem_tcvqkt	pos_fsnngx	tok_kosmqb
lem_awtifu	pos_fhmjjx	tok_sgecst
lem_gydmxi	pos_yhxivc	tok_xxaomk
lem_zbnhjg	pos_vskfkb	tok_tawujq
lem_irawsm	pos_zblynr	tok_mgmiyp
lem_ttlkjz	pos_rysoad	tok_mklaqg
lem_ifhraz	pos_lsfhub	tok_rljefg
lem_liaozm	pos_rrxvql	tok_lnokma
lem_vsumnz	pos_eigtxb	tok_dudifv
lem_dzpbam	pos_lflqof	tok_ecyjji
lem_bqbrva	pos_awyyps	tok_xmpvmf
.	PONfor	.
lem_ovjsiw	pos_tqwgnp	tok_paulxl
lem_tlcwin	pos_spcwnu	tok_cgqvnx
lem_boxeha	pos_ufbgds	tok_ofnoml
lem_rmyjiy	pos_vjfskn	tok_uoqymd
lem_qiyxzq	pos_uenagw	tok_nlcmiw
lem_dirhjn	pos_nzhnwi	tok_dwhkyq
lem_ekuyko	pos_aivgwq	tok_hgaltj
lem_cquydr	pos_ljzbhq	tok_ykodfz
lem_yzvvqg	pos_wcjlro	tok_cmaxxm
lem_vscwdr	pos_xoigrw	tok_qhvslu
lem_akfqab	pos_eowpmb	tok_omqscd
lem_drmgbw	pos_bglgun	tok_vikceu
lem_zulqtz	pos_bwjxvi	tok_zcvrpr
lem_wcnkei	pos_bmjibp	tok_akevpw
lem_ewwebn	pos_azotwj	tok_rxujmz
lem_xqaeql	pos_srhcmz	tok_sxlyba
lem_kacqlu	pos_foirzl	tok_tlyuut
lem_dthfaf	pos_jonokd	tok_treawm
.	PONfor	.
lem_egqpcf	pos_nzvavj	tok_lmrnob
lem_qykjli	pos_bhsvlq	tok_tigsib
lem_ixfwjb	pos_alszkr	tok_qfuwkx
lem_wknffe	pos_duvzsa	tok_hpmxsb
lem_xlwhkw	pos_ykjeps	tok_bxomos
lem_owpctk	pos_oznfor	tok_vjztgb
lem_wyvvon	pos_drplkh	tok_vgnyxm
lem_jgfedh	pos_lpaqwg	tok_skvppq
lem_jxxbds	pos_bqnfco	tok_znfgvx
lem_ejkhgz	pos_pypltf	tok_cqfesv
lem_llihqv	pos_crmqvf	tok_bwporj
lem_bxavjo	pos_cpzceq	tok_trmmin
lem_cllqye	pos_ixcanu	tok_vrwhxt
lem_cmxrar	pos_rqvcjn	tok_iqzbmr
lem_yykdem	pos_fsztwg	tok_bymekf
lem_enlovz	pos_qwdcrj	tok_pxuviw
lem_maqvpr	pos_pfzmyy	tok_xjcmxo
lem_ibeqak	pos_cqikdw	tok_ihekki
.	PONfor	.
lem_wywzmr	pos_smgljn	tok_ywfdmt
lem_czmyxx	pos_shcygk	tok_qfjabr
lem_pkhcbd	pos_iwqczu	tok_gdhoij
lem_mahsed	pos_pcwrqs	tok_wucmco
lem_hfrcpp	pos_cubadv	tok_hnslda
lem_yomwsy	pos_jqvkyr	tok_dtffve
lem_cgdtxz	pos_hpajra	tok_ovihkg
lem_qxukox	pos_rsurvj	tok_qgqtuu
lem_sjiwbh	pos_qjkqvj	tok_hcswjl
lem_tlqxzl	pos_paalcu	tok_igizqt
lem_etxode	pos_dzwfhm	tok_dvvvkg
lem_kjvtrt	pos_zvypgo	tok_hnhsky
lem_hqwpvs	pos_petfvj	tok_emuuge
lem_nhttzr	pos_fyfwvr	tok_zlgvqt
lem_dxdofo	pos_ytyuty	tok_cthdgv
lem_nhzzqj	pos_zpbikl	tok_xsuhty
lem_vffjxn	pos_ltnhja	tok_obctux
lem_qpzqno	pos_gatefl	tok_kmnxou
.	PONfor	.
lem_xhotay	pos_ohrahd	tok_xncbex
lem_wqmwvu	pos_gzgtye	tok_mawsrt
lem_lhpoum	pos_zsmvgi	tok_oxiwdh
lem_ruwons	pos_scodwl	tok_gseeav
lem_qwegnx	pos_tcbgna	tok_xntvqq
lem_czmvpt	pos_gugimo	tok_zodpar
lem_tkhciw	pos_zhbdyn	tok_dueqmj
lem_itynvu	pos_wajwxu	tok_pqraiy
lem_qhfeya	pos_lsoblr	tok_tcqujm
lem_ynweko	pos_pkesgc	tok_kdkkws
lem_ovpkst	pos_byjtnz	tok_rfwiof
lem_vequvv	pos_bxvgwb	tok_pxnfwt
lem_maukzy	pos_fmllgk	tok_mdrugz
lem_eypkgg	pos_oqguqv	tok_bztdfz
lem_thqjqr	pos_epnagr	tok_sntlvd
lem_qbcygu	pos_pqvmpe	tok_pzpilg
lem_vxsblt	pos_eibrgs	tok_fnqrxd
lem_joerti	pos_unyvki	tok_xxqzdr
.	PONfor	.
lem_shzkte	pos_hdlfuf	tok_ttvyjp
lem_rswily	pos_opimqf	tok_jyeexg
lem_oruuup	pos_ivisur	tok_fzvjvi
lem_fjnjfk	pos_kiyoda	tok_lbfgnw
lem_yaouvj	pos_jxghtg	tok_fvtbsn
lem_sjhnre	pos_phaczk	tok_mfejhr
lem_wduquc	pos_yrikmo	tok_oyiuyu
lem_ackgow	pos_tbxisg	tok_iymdjm
lem_dvdznl	pos_uqvbpi	tok_fofzwn
lem_lhtxkx	pos_nfdiai	tok_izrlfo
lem_yzfikg	pos_ssahsx	tok_wlhjlw
lem_uriejq	pos_razags	tok_smbtkj
lem_uudzmi	pos_mfccre	tok_elcdkc
lem_rwpslq	pos_urzvvj	tok_drrgzd
lem_qxxlkn	pos_udeqcl	tok_nsgwku
lem_njdnpa	pos_ennvme	tok_ojchwg
lem_wgyspc	pos_zmtkri	tok_vwgsas
lem_ftjnri	pos_iikeli	tok_kboxgr
.	PONfor	.
lem_rollrz	pos_jsifre	tok_sqgjbn
lem_cusxez	pos_wdbkzi	tok_ewjmls
lem_aspsbm	pos_fbaaqy	tok_cebjqg
lem_mxjyms	pos_sapwrx	tok_qxrosw
lem_unsppi	pos_pkvkkp	tok_zikzua
lem_xhlkbp	pos_donrsn	tok_vlkxfc
lem_anxkio	pos_louuyz	tok_owykuc
lem_nuiswb	pos_zdtrur	tok_wnomic
lem_bditas	pos_bawgcj	tok_vqbcll
lem_qmlagv	pos_wiwtel	tok_huaksa
lem_bcgjaq	pos_cxvuas	tok_pgiscu
lem_fdbbaw	pos_gucnxn	tok_tbkuoc
lem_skkcza	pos_gfpgdk	tok_tffzhs
lem_alxgjx	pos_kzjfcd	tok_mhomif
lem_vkdkid	pos_vfcaqb	tok_oqbkms
lem_chynln	pos_xpqmlt	tok_yomwir
lem_mwbiek	pos_gbqzxf	tok_ykdcip
lem_ffmifl	pos_tapufp	tok_nvlgdt
.	PONfor	.
lem_hrcwzl	pos_pyqetq	tok_dtvuht
lem_yqebqs	pos_oqsqam	tok_joednz
lem_vafong	pos_pmnpmj	tok_pdqonn
lem_sdbujv	pos_momrgg	tok_nonkbx
lem_zxjvny	pos_pvvyen	tok_zbcxcv
lem_ceggfu	pos_hcuwyc	tok_syraoh
lem_dgqdnn	pos_jocbzv	tok_tbdvzj
lem_vygmcy	pos_esztwa	tok_fpugob
lem_qfeysr	pos_wonyqo	tok_bwrmth
lem_nxsfrk	pos_qzxqiz	tok_oudecv
lem_nylcml	pos_fbkibe	tok_utkdfm
lem_wmfhkk	pos_qjzuht	tok_atrhrr
lem_tuppvp	pos_npotgu	tok_gkbqvk
lem_ozsbwu	pos_vbslbm	tok_xduwyy
lem_bjdxry	pos_xkreob	tok_ykqgzc
lem_pthqxl	pos_vklogj	tok_qcersx
lem_ybulsx	pos_pilhro	tok_ovbrwd
lem_zjzxpa	pos_pcjexr	tok_yyimcx
.	PONfor	.
lem_bntdmg	pos_ygvxmn	tok_nkzacf
lem_vguhvk	pos_tynyps	tok_gjnmuy
lem_ohglbb	pos_acqrto	tok_ewnezo
lem_cqzmtp	pos_hxagsy	tok_kraejo
lem_rgtwbu	pos_zntotg	tok_rlantn
lem_nsckgk	pos_ohhtsj	tok_boabqt
lem_rqvbgw	pos_fnxins	tok_fxqalj
lem_hsrgal	pos_ymxlpi	tok_ekwhuu
lem_qlowev	pos_ablyvc	tok_elyose
lem_csfrnn	pos_txahuv	tok_uthqmq
lem_tvhhno	pos_dkmpws	tok_grwrkn
lem_qkjsqr	pos_xzdebe	tok_lrhghp
lem_utqjfj	pos_jtufjc	tok_hftdvf
lem_ypkzdu	pos_iicldf	tok_jmfowi
lem_dsdoyh	pos_mdkzie	tok_tbpqam
lem_tuktyy	pos_adrupc	tok_zrghyd
lem_ripbpb	pos_ijpedk	tok_ylzrxv
lem_kicygo	pos_kxohlp	tok_detedb
.	PONfor	.
lem_jylqpt	pos_xttmpf	tok_rbqxdg
lem_fyhxjz	pos_ikxhwx	tok_yqfpsp
lem_wxanwh	pos_kfurja	tok_mhhpab
lem_gzrzfy	pos_nfyqmn	tok_tpshdu
lem_xbivtt	pos_nclvrj	tok_snohsj
lem_rvqhmd	pos_slraqp	tok_jljijg
lem_axuhnf	pos_hkxotf	tok_tguftt
lem_odjzbs	pos_viysjn	tok_jwkote
lem_meveth	pos_svjtez	tok_yhaduc
lem_xadjsz	pos_wqwzhi	tok_pzdgnp
lem_vxjfur	pos_lahcmm	tok_ppzhmw
lem_nfwgny	pos_mllsmp	tok_rjozzn
lem_vrxedx	pos_wxtlox	tok_noqyda
lem_cgdovp	pos_qegkmb	tok_bpcrwc
lem_xeiscs	pos_rrliif	tok_zjontw
lem_bgdyep	pos_zxhcjt	tok_unfcjt
lem_doodwv	pos_vhynhw	tok_xdgtgz
lem_vflbiq	pos_zaxmib	tok_mxsbmq
.	PONfor	.
