.	PUNfrt	DOT
lem_zxqzfd	pos_naqnky	tok_jvgycm
lem_mijdfx	pos_lzfgon	tok_jzebfg
lem_mewoxe	pos_dekutj	tok_rfgtjq
lem_cfkahs	pos_tvtqon	tok_zwlveq
lem_cvyiws	pos_orvqhl	tok_oqooqa
lem_sdlmgr	pos_peabmx	tok_yphhtt
.	PUNfrt	DOT
lem_lzwsjj	pos_srzczp	tok_avkjjd
lem_pjztsm	pos_qrmzib	tok_ueucmd
lem_aeeviy	pos_kwvzcb	tok_ebsawt
lem_gtdxes	pos_wuxjrg	tok_vyykwd
lem_gvdnuq	pos_dntjbm	tok_ngdbbb
lem_ihvhke	pos_bumxuq	tok_kzficr
.	PUNfrt	DOT
lem_sljjky	pos_teabtf	tok_fgalsr
lem_lapjjj	pos_jslknk	tok_zrftpa
lem_vgudow	pos_tbcxoh	tok_svfnfh
lem_jmzari	pos_pxbwng	tok_fndbgc
lem_ovwdzf	pos_buwenz	tok_sjhkyu
lem_keyuyq	pos_oidrbg	tok_gjvtor
.	PUNfrt	DOT
lem_yjgzmg	pos_joayqo	tok_karmkx
lem_hivtky	pos_eprvvl	tok_mqhhfk
lem_scdfys	pos_aydmnm	tok_rcyuxi
lem_gjlmpw	pos_kwcdto	tok_gqgwpc
lem_rpysfi	pos_tmhghd	tok_izzitk
lem_gcskqf	pos_lwsaxi	tok_bqjixy
.	PUNfrt	DOT
lem_lbvqyx	pos_ftldmk	tok_eoghcw
lem_evymcv	pos_zceazg	tok_strdpv
lem_txoogl	pos_bccear	tok_qlfiwl
lem_xkygin	pos_eiyhbz	tok_jlzjgz
lem_ztunaq	pos_zthwlx	tok_ufturg
lem_eykghe	pos_qotpik	tok_chxnli
.	PUNfrt	DOT
lem_npgmmg	pos_irxgmp	tok_yqjgny
lem_ehlpxx	pos_quoqyd	tok_legbhw
lem_emhkzk	pos_oxuybb	tok_frenrx
lem_yszoin	pos_vdhzyq	tok_tpyvgr
lem_fmvqlr	pos_amvkpv	tok_bbzrrh
lem_fwjiyz	pos_pdwvdb	tok_mnvtvv
.	PUNfrt	DOT
lem_yxntpn	pos_nuzoku	tok_psfeyy
lem_pitxxa	pos_zoaxzt	tok_qbctyj
lem_jvoxkh	pos_fblojf	tok_amwyej
lem_gvzirj	pos_rsmuhm	tok_rriiji
lem_jjlere	pos_mblpun	tok_rexvod
lem_xshnlx	pos_fomxpp	tok_pqeigu
.	PUNfrt	DOT
lem_qpsrie	pos_uufpja	tok_hwausy
lem_mblqkt	pos_oegnvq	tok_fcheym
lem_ilyybq	pos_myqitd	tok_ajkyhp
lem_otjtct	pos_pusebc	tok_srvopz
lem_cdimug	pos_vesciq	tok_jlaekq
lem_tpalrw	pos_qiaxrp	tok_cicjna
.	PUNfrt	DOT
lem_yctrbs	pos_yrkxjr	tok_ewvhjj
lem_hkbqap	pos_ovnglh	tok_scgcpe
lem_dqaqeq	pos_vgwyrv	tok_vhblxv
lem_qukvyr	pos_zyacdp	tok_riodsq
lem_aqdvik	pos_lzgnoy	tok_bjopmh
lem_qtulqv	pos_aobhza	tok_hnzehd
.	PUNfrt	DOT
lem_rwdiob	pos_equdux	tok_frhnpm
lem_iqosnt	pos_ksmhcv	tok_zwjeya
lem_tbtkky	pos_abzncx	tok_zdaxox
lem_dmwmyp	pos_tjqyxv	tok_oiwdhd
lem_omykqk	pos_eshbbn	tok_yszpah
lem_hrxclo	pos_xdvxso	tok_hwbkfl
.	PUNfrt	DOT
lem_ihnzny	pos_dswwlc	tok_oxwwbd
lem_qdtitk	pos_jpmlqi	tok_epavli
lem_xjsgph	pos_yzflsk	tok_slpvaj
lem_luakmb	pos_fqrinq	tok_omuvtr
lem_uiuflh	pos_ngctlm	tok_towvkg
lem_scpvpx	pos_ukqgqo	tok_xlxrii
.	PUNfrt	DOT
lem_iwczxg	pos_pfbdbt	tok_dbnijd
lem_afnkaq	pos_hccagu	tok_vieakp
lem_xejkkl	pos_fmwptw	tok_vyhojv
lem_vvchno	pos_hffuza	tok_xqtgef
lem_xsjygu	pos_jdmboz	tok_qlfogp
lem_urmyoe	pos_ejitpm	tok_jumadn
.	PUNfrt	DOT
lem_axfvur	pos_fdbudt	tok_yaxuvn
lem_vgqbic	pos_ehvftn	tok_uzhdvz
lem_cfoomo	pos_oslwdt	tok_irgphj
lem_rvokkp	pos_rxeicu	tok_kfgrsc
lem_azejta	pos_wmopkp	tok_klhmpt
lem_cfyqbm	pos_gshqta	tok_oltcib
.	PUNfrt	DOT
lem_sgpudi	pos_rsuwth	tok_ngipkq
lem_kmnfif	pos_utoriw	tok_tsoeis
lem_uctknz	pos_gyaise	tok_njnxek
lem_qulanu	pos_olwwwz	tok_echors
lem_ownpyp	pos_uonunf	tok_cvmkiz
lem_vpqvbj	pos_povhce	tok_nmwcbf
.	PUNfrt	DOT
lem_khoxki	pos_fqndrk	tok_igbqrf
lem_ynwevf	pos_kczyqr	tok_hhycth
lem_awggyu	pos_mygkrm	tok_wxxwvc
lem_ktguen	pos_vbfouf	tok_yynedk
lem_gupogg	pos_xhaaxx	tok_ludwat
lem_jdxxox	pos_skxyzt	tok_zayzmc
.	PUNfrt	DOT
lem_jbiluz	pos_mhwsvy	tok_lierpr
lem_hqsveo	pos_chssnb	tok_echexv
lem_epfqqq	pos_lriyvx	tok_sfkufw
lem_exnlzf	pos_nbemfv	tok_ijdpcc
lem_kyafyq	pos_knnwyw	tok_qxowrm
lem_vpbbxe	pos_bqiywt	tok_suijpq
.	PUNfrt	DOT
lem_chezxv	pos_mwoqem	tok_wyupno
lem_lelgab	pos_lxwmwx	tok_hzfpcx
lem_kcfjhz	pos_vaugic	tok_ooqczz
lem_mitivf	pos_ragxhc	tok_slzgua
lem_ojynjl	pos_tdbbif	tok_koohyx
lem_mlizol	pos_rkwufn	tok_jzmmtu
.	PUNfrt	DOT
lem_zmmwmq	pos_ohfuwj	tok_xbxpmb
lem_ergmzy	pos_dehfeh	tok_nrqxkh
lem_kxtywg	pos_riunee	tok_dzumpl
lem_uyrfqh	pos_zucegw	tok_wccvvh
lem_soyymd	pos_sqkwpu	tok_zgvoml
lem_unedzz	pos_enzhsv	tok_ojsvfg
.	PUNfrt	DOT
lem_bfhtob	pos_uuupbd	tok_grqyfp
lem_mfpaou	pos_osuknf	tok_aftbsg
lem_oqvcub	pos_wwkvuc	tok_zmpzjj
lem_twwhbh	pos_wxoago	tok_fvprlq
lem_iezmeq	pos_xoslkc	tok_qltaxj
lem_xbzvue	pos_mndrpg	tok_adlivf
.	PUNfrt	DOT
lem_oemogc	pos_inamcb	tok_rznuya
lem_hkdnbk	pos_zblubd	tok_aajadc
lem_mqgxaj	pos_qcfhsb	tok_hcwwoe
lem_lcfhje	pos_zvkddm	tok_ubecln
lem_hkllgv	pos_bkavum	tok_cprpjg
lem_dfacgy	pos_uxuvww	tok_idavwn
