lem	pos	tok
lem_jpomfr	pos_vmnzqw	tok_hzbqun
lem_rzcftn	pos_eeiabi	tok_lkbqza
lem_xgumco	pos_pivdjj	tok_lvjico
lem_uxwyhw	pos_jsnpbt	tok_uxvopw
lem_ysicxi	pos_tgzhth	tok_tlxorz
lem_opymvq	pos_yildji	tok_czjewn
lem_dfstgx	pos_uuzfin	tok_zcytbo
lem_inrhhz	pos_yshgod	tok_acqowm
lem_pqnoes	pos_mrhryw	tok_akepwf
lem_joshhl	pos_grakjq	tok_mqpqby
lem_gjydqn	pos_ozvyht	tok_veckle
lem_zzyjkn	pos_mebcak	tok_vjtnxg
lem_ubnwbl	pos_pzslhu	tok_attjqb
lem_bgkmlk	pos_jzunqb	tok_ggkeft
lem_cmzail	pos_gxymuk	tok_shhihm
lem_glyzzg	pos_gmljmi	tok_tqsnpa
lem_aiyvqf	pos_dhakza	tok_cucyco
lem_ryzncs	pos_amkjrf	tok_qlqoud
lem_wnpvkw	pos_enakpw	tok_rvxhfd
lem_qvyawb	pos_kbhcfx	tok_rrapsp
lem_xizrws	pos_ywctdv	tok_vojhfj
lem_nilife	pos_apcbve	tok_ahlksf
lem_xzckew	pos_ahikhb	tok_ekmpxf
lem_jggsan	pos_fsmtkz	tok_haiyzv
lem_oponqk	pos_jkqwgq	tok_tuqxry
lem_khnqtn	pos_qhpmdj	tok_zvnlpz
lem_xkfrhz	pos_pxodxx	tok_qceksb
lem_gdzvkw	pos_foawda	tok_gmrtbc
lem_uuales	pos_cuksnj	tok_mbvupb
lem_sktsmj	pos_jnhjkx	tok_dmcgjz
lem_jfdyod	pos_qyjock	tok_jukwqu
lem_jawped	pos_kswjwu	tok_fgdyeb
lem_aafyzq	pos_crheeb	tok_msougn
lem_gulzcd	pos_oakxtd	tok_vgydxg
lem_jpqcuj	pos_rdgrtb	tok_gjoacr
lem_ztobsb	pos_ynmlfe	tok_nlbbrg
lem_msfpxd	pos_zcpvfe	tok_llusul
lem_tteddu	pos_gkjmxj	tok_xybbqp
lem_damqip	pos_dsxknq	tok_kyyews
lem_qviktc	pos_tnrhro	tok_zrakpx
lem_ahxuty	pos_lqmcef	tok_bhckue
lem_ruaufq	pos_egklkh	tok_sgsflo
lem_zfyvhk	pos_kmhkef	tok_mcjqrl
lem_vuvqer	pos_wbuudl	tok_jehhuz
lem_yonuen	pos_jowolf	tok_gnvjqi
lem_lzmhgb	pos_toqiev	tok_ovssuz
lem_ujkezp	pos_jjnsjl	tok_ovmigx
lem_aygmee	pos_ntbbhr	tok_dtluyg
lem_hqxeio	pos_vfyyzy	tok_djakwc
lem_xvtgil	pos_klmehx	tok_ksocnn
lem_jikjjo	pos_sfqevn	tok_laykcx
lem_frvvao	pos_nepffu	tok_zrvhda
lem_qhnuxo	pos_pijawr	tok_eszlqe
lem_tybxfh	pos_nswrln	tok_vhbzxx
lem_zpwreo	pos_qyfhxh	tok_kykghs
lem_rprlni	pos_wamsrj	tok_srdoxo
lem_tvshxq	pos_tkqfwd	tok_kdvtxz
lem_bapxdk	pos_nvcplz	tok_cnylkz
lem_nkpfge	pos_ippevq	tok_lhgagj
lem_luedvn	pos_topvgn	tok_zpomfx
lem_pxsksb	pos_ligdwc	tok_umquqf
lem_krfnzu	pos_znnlkp	tok_kpmtsf
lem_bzutga	pos_fogswn	tok_ihaibf
lem_cmdpuh	pos_hfefbz	tok_tbjjzz
lem_wqqais	pos_qyjcbq	tok_yfwzck
lem_rqyzzo	pos_odcswk	tok_yeviji
lem_womatg	pos_yucdbe	tok_fgdhdk
lem_jrgxuj	pos_pormvq	tok_hfgwgj
lem_nthjmp	pos_ihtanh	tok_reltzy
lem_oqtsng	pos_ftoopi	tok_wowjmk
lem_tmhnvg	pos_wnxref	tok_itnbgr
lem_atucia	pos_jeztqe	tok_qnzgkd
lem_iuysri	pos_zsggod	tok_dggdvg
lem_vaxghw	pos_etwwgp	tok_fmeafg
lem_ssseuc	pos_xipgac	tok_suonvr
lem_ugvxwl	pos_nliwin	tok_qlomng
lem_bgjsmh	pos_grychp	tok_velwkd
lem_yranxv	pos_izdtey	tok_bamqqt
lem_wgrqvh	pos_fqttwl	tok_gmoxhy
lem_abkcat	pos_ibgsyr	tok_fuyhdq
lem_tkvlwg	pos_kedfbh	tok_wiuwaf
lem_rdwkka	pos_omirsb	tok_kneaob
lem_bnsudw	pos_ummvva	tok_rlmasr
lem_letfof	pos_lqavqe	tok_odmqjy
lem_irlvfk	pos_fsrkpc	tok_pbuykv
lem_maglhz	pos_jjpkva	tok_tcmxrq
lem_nsebcd	pos_xsdkvj	tok_mdlkee
lem_nmarqk	pos_hsxbgu	tok_dsxdif
lem_sxnqni	pos_xmhvnz	tok_ivbyzq
lem_gdkqip	pos_fhiizz	tok_jbmafv
lem_mlqnhk	pos_rknjix	tok_dualsz
lem_ipbzjk	pos_imuuqh	tok_zzfgtq
lem_nxerdt	pos_uqydoy	tok_dfisoc
lem_dollac	pos_ozjtlv	tok_uhsreo
lem_ydtafp	pos_jldotp	tok_crcnhm
lem_tbdisl	pos_tbtlyv	tok_zmuojb
lem_cxtxnd	pos_fvmulg	tok_ifwpxh
lem_gsepnl	pos_xlbfrp	tok_efuhbr
lem_blxrbp	pos_ulawzp	tok_oqfbqh
lem_igmggp	pos_hvmpyg	tok_bmohsi
lem_wgoayx	pos_scqhci	tok_bcwuxx
lem_jeqsnn	pos_baxgge	tok_lprhas
lem_pblxvd	pos_vvucox	tok_owqpab
lem_nqbdmi	pos_hmptsg	tok_zjcbsg
lem_ghrwmp	pos_twbetf	tok_dwzbzz
lem_bbqmax	pos_qmlzke	tok_kvdeug
lem_hikqcn	pos_ndnzsa	tok_mfmrjy
lem_bldthw	pos_xadimx	tok_mgxdbr
lem_fvcwdo	pos_muxuzj	tok_ftkbqw
lem_agmmfl	pos_vfpyof	tok_ukecov
lem_jwczkl	pos_fjkjzq	tok_alymel
lem_fwsmrp	pos_ztgzwv	tok_jasacz
lem_mwnzri	pos_nfwkxs	tok_brabwc
lem_qyjttw	pos_uysvxh	tok_waexus
lem_wuiqqn	pos_orwmrt	tok_npfhvm
lem_csaqrf	pos_nqfcxg	tok_mhwpwg
lem_hkxwea	pos_kywrmo	tok_tgccum
lem_kkgjhy	pos_isdbmk	tok_oxnhen
lem_eeocfw	pos_wxpxrl	tok_znvioh
lem_ilivmg	pos_rcoeza	tok_mgpoxf
lem_nnpbaj	pos_gnakji	tok_rtarvv
lem_siowvz	pos_lxgbph	tok_bhtmik
lem_dunfob	pos_iuffdg	tok_npywdn
lem_hpvllp	pos_rbrftd	tok_jyccea
lem_uzidhm	pos_bclmkh	tok_uqsimr
lem_slizrh	pos_arccrq	tok_ipenao
lem_tlfljn	pos_vhlmlp	tok_ovywhf
lem_mbawzy	pos_kjxgws	tok_glhokt
lem_ojycow	pos_rjprrp	tok_mqjlgn
lem_ugcdkk	pos_hdciif	tok_pnzozp
lem_fzrcpu	pos_hnnzfb	tok_cdhqta
lem_gqachs	pos_rwkupj	tok_sjzepl
lem_mhwcbi	pos_vpxefv	tok_fzwolf
lem_frmxfe	pos_szbdwb	tok_kodugi
lem_frddht	pos_cgljca	tok_nphewr
lem_ilfkjy	pos_eetagp	tok_qicgmw
lem_jnqaym	pos_mxtsql	tok_jgmzpw
lem_hxefix	pos_zirepn	tok_oyppcr
lem_owxomh	pos_aavvpp	tok_flcegl
lem_eipbyw	pos_dphdbk	tok_eqxyat
lem_euxvji	pos_uqjcbr	tok_xqayhp
lem_smohtq	pos_xgfubw	tok_sibdtp
lem_mdksnk	pos_pmyxbh	tok_cranvt
lem_bzzspx	pos_qcokpb	tok_oasxwv
lem_vfsnlt	pos_wdwhjo	tok_rpwrka
lem_twiolq	pos_ezszlz	tok_ahqevo
lem_pgsjzw	pos_sgxwjb	tok_fslhlu
lem_vpevcu	pos_pliyww	tok_gikzwd
lem_zxsdng	pos_tlnwjo	tok_ccjcfa
lem_dnuafa	pos_lepfvf	tok_tsiofb
lem_vnrmwz	pos_jaaxxk	tok_axahlc
lem_zjriix	pos_hbkzqu	tok_snjhvs
lem_zbbyfr	pos_ukaase	tok_ncwffr
lem_eqfxxg	pos_qbncsv	tok_oslupj
lem_gezlxr	pos_glepey	tok_bxqbuq
lem_tmrjby	pos_bskxzn	tok_imfjzc
lem_weuetw	pos_xpmteu	tok_qbhfwb
lem_cslyml	pos_jpuzth	tok_weetbu
lem_hvzsay	pos_fmxbhu	tok_nfnbyy
lem_xkchie	pos_kmmvoj	tok_rfdcfc
lem_wbpmhf	pos_vdgcpf	tok_uzdczq
lem_hlblru	pos_ggsdxl	tok_nscwwg
lem_ozubji	pos_acqfzc	tok_obzfey
lem_fmisfm	pos_yjpgzb	tok_rrddpx
lem_imhzqi	pos_joclmz	tok_hutzhy
lem_yagaqs	pos_yesucg	tok_bkiwij
lem_ldnfid	pos_tnoigv	tok_vxdktf
lem_xpujlp	pos_mfyxfo	tok_hwpovp
lem_hthjdb	pos_kvipwz	tok_hmhiax
lem_rzadgi	pos_lwzyzn	tok_zjpavd
lem_oykkbz	pos_dxzisl	tok_zbrdxz
lem_tvtzum	pos_gklhmz	tok_fmiehl
lem_ekyyig	pos_odlrty	tok_lyraod
lem_mlthuj	pos_ezfmmm	tok_sovhqb
lem_xpmrba	pos_ulwscc	tok_xtbald
lem_eemmqf	pos_rvmdsj	tok_cuwsqz
lem_cmujvt	pos_poyuuf	tok_swsjyn
lem_wxqxjr	pos_plwcdi	tok_whgsmj
lem_nmhinn	pos_lldutm	tok_fhqnww
lem_ryvouj	pos_ezsjkl	tok_hhjivw
lem_yqwrqq	pos_ubkzsk	tok_fzbsnx
lem_dnkhdv	pos_snkzci	tok_cnoixd
lem_pvlzob	pos_bwcodu	tok_rhnhkf
lem_nlsbgn	pos_uyeuum	tok_xlypvk
lem_aybekb	pos_lsqvpq	tok_svxbmy
lem_ytvdym	pos_rsezmn	tok_zovmyy
lem_xhgcid	pos_mdraij	tok_pmtkip
lem_krujxh	pos_nxrkkv	tok_olfull
lem_hbddsf	pos_obauuc	tok_pjjzru
lem_gwuojr	pos_gzjsom	tok_hittzi
lem_chyqej	pos_yctdsz	tok_gmweur
lem_vzevos	pos_wjhxlo	tok_yetafm
lem_shwkhc	pos_gwkqqc	tok_azsbth
lem_seqmlq	pos_uducbk	tok_bbfktu
lem_vgnkeu	pos_vpeibh	tok_upxbqp
lem_nvslbp	pos_occkcv	tok_mbtxbm
lem_ahbtck	pos_yblmsv	tok_zbiytc
lem_ljzgcl	pos_qayuqu	tok_nbsvtn
lem_elffbe	pos_atibcq	tok_kziwwm
lem_zwudat	pos_ndrzzd	tok_tjgrdk
